Former Nazi death camp guard Demjanjuk 	convicted Nazi death camp guard 
at 91 	aged 91 
dead 	dies 
women 	Saudi Women 
to compete 	To Compete 
to permit 	Allowed 
in Olympics 	At Olympics 
in Pakistan 	in Pakistan 
5 militants 	four suspected militants 
US drone strike 	Drone strike 
kills 	kills 
Syria peace plan conditions 	Syria peace 
Syrian regime 	Syria 
in Houla massacre 	for Houla massacre 
mixed 	higher 
Friday 	midday Friday 
close 	close 
China stocks 	Chinese stocks 
used 	used 
Mall attackers 	attackers 
` less is more ' strategy 	` less is more ' strategy 
strikes off 	strikes off 
6.8 quake 	Magnitude 6.3 quake 
Solomon Islands 	Solomon Islands 
opposition coalition 	opposition 
Friends 	Friends 
recognizes 	recognize 
as legitimate representative 	as sole representative 
of Syria 	of Syria 
7 	7 
detained 	detains 
for ` house sister ' scandal 	for `` house sister '' scandal 
takes a beating 	tumbles 
Boeing 787 Dreamliner 	on 787 Dreamliner 
stock 	Boeing stock 
catches fire 	after fire 
abduct 	kidnapped 
in Nigeria 	in Nigeria 
seven foreign workers 	Seven foreign workers 
in West Bank , Jerusalem 	in W. Bank 
clash with 	clash with 
Palestinians 	Palestinians 
Israeli forces 	security forces 
killed 	killed 
in Pakistan 	in NW Pakistan 
in bus accident 	in road accident 
12 	10 
North Korea 	North Korea 
Postpones 	postpones 
Family Reunions 	family unions 
with South 	with South Korea 
David Beckham 	David Beckham 
Retirement 	retires 
From Soccer 	from football 
Man 	Man 
on National Mall 	on National Mall 
Dies 	dies 
Who Set Himself on Fire 	who set himself ablaze 
's Prime Minister 	's prime minister 
Shinzo Abe 	Shinzo Abe 
as Japan 	Japan 
Selected 	is 
in a coma 	in a coma 
Schumacher 	Michael Schumacher 
after ski accident 	skiing accident 
Bradley Cooper and JJ Abrams 	Bradley Cooper 
in talks 	in talks 
a Lance Armstrong biopic 	Lance Armstrong 
about filming 	to play 
horsemeat scandal 	over horse meat scandal 
EU ministers 	EU ministers 
Thai opposition party 	Thai opposition 
general election 	election boycott 
in Seemandhra 	in Seemandhra 
to hospital 	in hospital 
Jagan Reddy 	Jagan 
continues 	continues 
power crisis 	blackout 
as Maracana re-opens 	as Maracana re-opens 
by England 	by England 
tied 	held 
2-2 	2-2 
Brazil 	Brazil 
warns against 	weighs into 
George W. Bush 	George W Bush 
bitter immigration debate 	immigration debate 
Hundreds 	Hundreds 
of Bangladesh clothes factory workers 	in Bangladesh factory 
ill 	sick 
conducts 	launches 
on Syria 	against Syria 
Israel 	Israel 
airstrike 	new airstrike 
Around 100 dead or injured 	Hundreds dead or injured 
after China earthquake 	in China quake 
2 French Journalists 	Two French journalists 
Killed 	killed 
in Mali 	in Mali 
in collapsed Japan tunnel 	from Japan tunnel 
ablaze 	left burning 
Vehicles 	Vehicles 
attack 	attack 
Islamists 	Islamists 
north Mali city 	in Gao 
fiscal cliff deal 	on `` fiscal cliff '' 
approves 	reached 
higher 	higher 
China stocks 	China stocks 
close 	close 
convicted 	Fined 
of tax evasion 	in Italian Tax Case 
Dolce and Gabbana 	Dolce and Gabbana 
on Syrian chemical arms 	over Syria chemical claims 
UK alert 	West 
in plane crash 	in plane crash 
Mexican singer Jenni Rivera 	Jenni Rivera 
believed killed 	dies 
Death toll 	Death toll 
climbs 	rises 
in Indonesia boat sinking 	in Indonesia boat capsize 
to 15 	to 11 
preliminary results 	in initial Iran count 
Rouhani 	Rouhani 
leads 	leads 
before pro-Morsi protests 	for massive protests 
security 	bracing 
Egypt 	Egypt 
hits 	climbs 
death toll 	death toll 
Bangladesh building collapse 	Bangladesh building-collapse 
362 	to 580 
2 dead 	2 dead 
2 injured 	2 hurt 
in Nevada middle school shooting 	in middle school shooting 
mixed sex schools ban 	in mixed-sex school ` ban ' 
Hamas 	Hamas 
Russia 	Russia 
gives 	gives 
to American adoption ban 	to adoption ban 
initial OK 	initial approval 
Among 7 Dead 	among 7 dead 
After Florida Apartment Shooting 	after Fla. apartment shootout 
Gunman 	Gunman 
the deaths 	The deaths 
to the police 	by police 
New information 	after they received information 
of Princess Diana and Dodi Fayed 	of Princess Diana and Dodi Al Fayed 
's death 	Diana and Fayed death info 
against Pakistan 	against Pakistan 
pledges 	promises 
Narendra Modi 	's Modi 
tough stand 	tough stance 
Boy Scouts 	Boy Scouts 
decision 	vote 
delay 	delays 
gays 	on gays 
on admitting 	on lifting 
0.26 pc 	1.53 % 
Tokyo stocks 	Tokyo stocks 
close down 	close down 
USA 	U.S. 
expels 	expels 
Venezuela diplomats 	Venezuelan diplomats 
warns 	warns 
record profits 	13 % rise 
Ryanair 	Ryanair 
reports 	reports 
this year 	this year 
growth 	of slower growth 
Opposition leaders 	Cambodia opposition leaders 
Commonwealth summit 	Commonwealth summit 
Indian media 	Indian PM 
gay marriage bill 	gay marriage 
backs 	backs 
Yvette Cooper 	White House 
killed 	9 Dead 
in new Darfur tribal clashes 	in New Darfur Tribal Clash 
after deadly Bangladesh building collapse 	as Bangladesh building toll 
arrested 	arrested 
8 	Four 
Afghans 	Afghan District Governor 
Taliban 	To Taliban 
divided 	divided 
in Afghanistan 	in Afghanistan 
17 civilians 	10 police 
kill 	kill 
Taliban attacks 	Series of attacks 
Texas residents 	Residents 
after deadly blast 	to Texas blast site 
Mali 	Mali 
for president 	After Presidential Runoff 
to vote 	Votes 
Central African Republic president 	Central African Republic President 
overthrown 	stepping down 
North Korean nuclear test 	controversial third nuclear test 
in Russian coal mine blast 	in Russia coal mine blast 
18 	Ten 
trapped 	killed 
Blizzard hammers 	Blizzard wallops 
U.S. Northeast 	US Northeast 
hits 	shakes 
6.9 magnitude earthquake 	5.6 magnitude earthquake 
New Zealand 	Iran 
Daily Press Briefing 	Daily Press Briefing 
South Sudan 	Syria 
French parliament 	Russian parliament 
Manning 	Ariel Castro 
in prison 	in prison 
sentenced 	sentenced 
to 35 years 	to 1,000 years 
lower 	higher 
China stocks 	China stocks 
on Friday 	on Wednesday 
close 	close 
in Texas fertilizer plant blast 	of Texas fertiliser plant blast 
Syria 	Syria 
the U.S. 	US 
chemical weapons 	chemical weapons 
reiterates 	announces 
to phase out 	to change 
plan 	plans 
polymer notes 	polymer Naira notes 
India gang-rape victim 	Indian rape victim 
Yacimovich 	Israel 
to approve 	agrees 
Palestinian prisoners 	104 Palestinian prisoners 
release 	to free 
over settlement plans 	over settlements 
Israeli envoys 	Israeli envoy 
summoned 	summons 
Obama 	in Obama 
in State of the Union 	's State of the Union speech 
convicted 	jail time 
in Kosovo organ trafficking case 	in organ trafficking case 
Five 	3 
kills 	kill 
in Iraq 	in Iraq 
of bombings 	Car bombs 
15 	49 
kill 	kill 
nine people 	6 soldiers 
in northwest Pakistan 	in northwest Pakistan 
Gunmen 	Militants 
after deadly Bangladesh building collapse 	after Bangladesh building collapse 
Snowden 	Snowden 
against protesters 	about protests 
kill 	kills 
in southern Iraq 	in northern Iraq 
8 	14 
2 car bombs 	Car bombing 
7 August 2013 	11 April 2013 
Pictures of the day 	Pictures of the day 
Red panda 	Missing red panda 
from National Zoo 	to National Zoo 
vanishes 	returned 
Taiwan 	SW Pakistan 
hits 	hits 
6.3-magnitude earthquake 	7.7-magnitude earthquake 
Heats Up 	soar 
Google and IBM Post Strong Earnings 	on strong earnings 
Tech Sector 	Google shares 
's presidential candidates 	as presidential candidate 
kills 	kill 
Car bombing 	Car bombings 
in Damascus 	in Iraqi capital 
53 	13 civilians 
Syria 	Iraq
protests 	at protesters 
in Istanbul 	in Istanbul 
Turkish PM 	Turkish police 
Start 	starts 
of San Fermin bull-running festival 	San Fermin bull-running festival 
Former LAPD officer 	Former CIA officer 
Pakistan court 	Pakistan-UN report 
50th anniversary 	On 50th anniversary 
's death 	of JFK death 
remembered 	its first memorial 
Israel 	Gov ' t committee 
frees 	release 
Palestinian prisoners 	of 26 Palestinian prisoners 
with Mandela family 	to Mandela 
meets 	meets 
Obama 	Obama 
's leader 	Egypt president 
state 	state 
imposes 	declares 
of emergency 	of emergency 
in 3 cities 	in three cities 
Nobel Peace Prize 	2012 Nobel Peace Prize 
receives 	Receives 
EU 	EU 
to Death 	to Death 
for War Crimes 	by War Crimes Tribunal 
Sentenced 	Sentenced 
at Swedish consulate 	Swedish Consulate 
Car bomb 	Car Bomb 
no casualties 	None Hurt 
's Benghazi 	in Benghazi 
roadmap 	High Hopes 
will yield 	Spur 
nuclear talks 	Iran Nuclear Talks 
North Korea 	North Korea 
conducts 	Confirms 
third nuclear test 	Third Nuclear Test 
Hits 	hits 
in 2012 	in 2012 
Record $ 38 bn 	record US$ 38b 
Macau Gambling Revenue 	Macau gambling revenue 
for Same-Sex Marriages Hearing 	for same-sex marriage 
Prepares 	pave the way 
NM County 	Some county officials 
to host 	to host 
2020 Olympic Games 	2020 Olympics 
Tokyo 	Tokyo 
in Mumbai rape case 	in gang-rape case 
Indian police 	Mumbai police 
all five suspects 	fifth suspect 
round up 	arrest 
Syria 	about Syria 
on chemical weapons 	's chemical weapons 
US 	U.S. concerns 
strengthens 	weakens 
China yuan 	Chinese yuan 
to 6.2689 	to 6.2816 
against USD 	against USD 
in new constitution 	On New Constitution 
votes 	Vote 
Egypt 	Egyptians 
in Benghazi 	in Benghazi 
kills 	hits 
Car bomb 	Car bomb 
French-led troops 	French-led troops 
on Timbuktu 	to Timbuktu 
at joint industrial zone 	to joint industrial zone 
to halt 	blocks 
N Korea 	North Korea 
work 	access 
Egyptians 	Egyptians 
vote 	vote 
on divisive constitution 	on constitution change 
final big immigration decisions 	final big decisions 
nears 	nearing 
Committee 	Senate Judiciary Committee 
for Boston bomb victims 	for Boston victims 
observes 	observes 
London Marathon 	London Marathon 
silence 	silence 
40 	40 
in Canada train disaster 	in Canadian train wreck 
missing 	missing 
UN presses 	UN chief presses 
for major boost 	for major boost 
in Syrian aid 	in Syrian aid 
N Korea 	N. Korea 
controversial rocket launch 	controversial rocket launch 
may delay 	to delay 
rocks 	rocks 
Critical Gates memoir 	Gates blast 
Obama administration 	Obama administration 
to hacking charges 	at phone hacking hearing 
Brooks 	Brooks 
not guilty 	not guilty 
pleads 	pleads 
is working 	work 
health care law 	new health care law 
declares 	pledges 
Obama 	Obama 
protest 	protest 
Thousands 	Thousands 
gay marriage 	gay marriage 
paralyse 	besiege 
Thai political protests 	Thai protesters 
more ministries 	more ministries 
Exclusive-UPDATE 	EXCLUSIVE-UPDATE 
2-Egypt pro-Mursi alliance signals flexibility 	1-Egypt pro-Mursi alliance signals flexibility 
in talks 	in talks 
Deaths 	at least one dead 
confirmed 	say 
after helicopter 	after helicopter 
into Scottish pub 	into pub 
crashes 	crashes 
Pakistan jailbreak 	Taliban prison break 
Militants 	250 militants 
stage 	escape 
brings 	wallops 
Blizzard 	Blizzard 
US northeast 	US Northeast 
bomb 	bomb attack 
Egypt interior minister 	's interior minister 
survives 	survives 
's security restrictions 	's security decree 
Critics 	of critics 
Putin 	Putin 
cracks down 	cracks down 
Egypt army 	's military 
on Brotherhood 	on Muslim Brotherhood 
for calm 	for calm 
Egypt 	Egypt 
prays 	prays 
braces 	braces 
for more protests 	for more protests 
between Raffles Place , Marina Bay 	between Raffles Place and Marina Bay 
disrupts 	disrupted 
train service 	Train service 
Defiant Mugabe 	Mugabe 
sworn in 	sworn in 
for seventh term 	for another term 
Lance Armstrong 	Lance Armstrong 
to Oprah 	in Oprah interview 
all 	to doping 
confesses 	confesses 
after wild party 	after alleged embassy orgy 
sacked 	resigns 
Honduran ambassador 	Honduras ambassador 
on upbeat US economic data 	by positive US , China data 
Asian markets 	Asian markets 
gain 	lifted 
six global powers 	world powers 
landmark nuclear deal 	nuclear deal 
Iran 	Iran 
sign 	agree 
Dozens 	Dozens 
in air strike 	in Syrian air strike 
on bakery 	on bakery 
killed 	killed 
Obama 	Obama 
Mandela ` Inspiration ' 	's inspiration effect 
Praises 	hails 
3-wk high 	three-week highs 
Asian markets 	Asian stocks 
on hopes 	on hopes 
of US debt deal 	of U.S. debt deal 
hit 	hit 
Patriot missile battery 	Patriot missile batteries 
NATO 	Obama 
on Syrian border 	near Syrian border 
Guinea 	Equatoguineans 
votes 	vote 
in long-delayed legislative poll 	in legislative polls 
on Sinai Militants 	against Sinai militants 
Egypt Army 	Egypt 
New Air Raids 	new assault 
Launches 	launches 
killed 	die 
vote 	polling stations 
Thai protesters 	Thai protesters 
obstruct 	block 
North Korea 	North Korea nuclear test 
Nelson Mandela memorial service 	Nelson Mandela 
killed 	killed 
in bus crash 	in bus accident 
in Italy 	in Pakistan 
37 	12 
Syrian opposition 	Syrian opposition 
Delhi Gang Rape Suspect 	Delhi gang-rape verdict 
the Philippines 	Philippines 
hits 	Hits 
Most powerful typhoon 	Typhoon Utor 
for more Egypt protests 	from Egypt protests 
11 hurt 	33 hurt 
One dead 	6 dead 
Suicide Bomber 	Suicide Bomber 
at Afghan Province Council 	in Afghanistan 
14 	11 
Kills 	Kills 
of manslaughter 	of murder 
arrested 	arrested 
on suspicion 	on suspicion 
on Wall St lead 	on Wall Street 
Stocks 	Stocks 
soar 	slump 
in northern Iraq 	in northern Lebanon 
17 	2 
in bomb attacks 	in clashes 
killed 	killed 
wounded 	wounded 
133 	6 
's death 	's death 
over nurse 	over nurse 
ailing Mandela 	's former PM Nelson Mandela 
South Africans 	South Africa 
December 6 , 2013 	July 12 , 2013 
's Must-Reads 	's Must-Reads 
The Note 	The Note 
for Friday 	for Friday 
to Central African Republic 	in Central African capital 
hits 	jolts 
6.0-magnitude quake 	5.0-magnitude quake 
Greece 	Japan 
North Korea Nuclear Test 	North Korea nuclear test 
Credibility 	world credibility 
on the line 	on line 
to 6.2767 	to 6.1818 
's yuan 	China yuan 
against USD Thursday 	against USD Tuesday 
weakens 	weakens 
kills 	Kill 
Suicide bomber 	Suicide Bombers 
policeman 	3 Soldiers 
in Pakistan 	in Pakistan 
to be sentenced 	Sentenced 
for terror convictions 	for Corruption 
Stocks 	US stocks 
rise 	ease 
in early trading 	in choppy trading 
to helicopter crash 	over crash 
UK police 	China police 
41 	15 
killed 	killed 
in Iraq 	in Iraq 
wounded 	wounded 
in violent attacks 	in fresh attacks 
22 	90 
to visit 	visit 
Kerry 	Kerry 
Jordan 	to Israel 
on agenda 	postpones 
for Obamacare 	for Obamacare 
signs up 	to sign up 
US State Department 	State Dept security chief 
faulted 	resigns 
over Benghazi 	after Benghazi 
Syria 	Libya 
Hit 	hit 
Kill 	kill 
6 	4 
Egypt Military 	Egypt military 
Suicide Bombs 	Suicide bombs 
in Sinai 	in Sinai 
in Egypt clashes 	clash 
killed 	injured 
Four Morsi supporters 	as Morsi supporters 
Pistorius officer 	Pistorius officer 
from case 	on attempted murder charges 
Pakistani Taliban chief Hakimullah Mehsud 	Hakimullah 
killed 	's killing 
in drone strike 	in bloodshed 
suspect 	suspect 
was captured 	captured 
Flooding 	California wildfire 
evacuation 	evacuation 
forces 	forces 
of another city 	of homes , university 
rises 	rises 
to 30 	to six 
Death toll 	Death toll 
in Nigeria police attack 	in Kenya bus attack 
Australia 	Australian PM 
Iran 	Iran 
in nuclear talks 	`` peaceful '' nuclear program 
's Darfur 	in Abyei clash 
Seven peacekeepers 	Peacekeeper 
killed 	killed 
on Syria 	at Syria 
over Israeli strikes 	second air strike 
voices 	confirms 
fire 	Fired 
tear gas 	Tear Gas 
at Brotherhood protesters 	At Gang Rape Protesters 
US Senate 	House 
on fiscal cliff deal 	on fiscal cliff deal 
to vote 	vote 
in Colorado avalanche 	in Colorado avalanche 
buried 	killed 
5 people 	5 snowboarders 
to US defense budget 	in defense spending 
`` political '' changes 	proposed cuts 
Hagel 	Hagel 
approve 	approves 
Afghan legislators 	Afghan president 
new election law 	new election law 
die 	die 
in fire 	in electrical fire 
Myanmar mosque fire 	at mosque 
13 children 	13 children 
With Higher Glaucoma Risk 	glaucoma risk 
Birth Control 	Contraceptive pill 
Linked 	doubles 
Iraqi president 	Iraqi president 
health problem 	stroke 
in hospital 	in hospital 
due to 	after suffering 
Near the Iranian Embassy 	near Iranian embassy 
in Beirut 	in Beirut 
Explosions 	Two blasts 
on flights 	on direct flights 
U.S. 	US 
carry-on liquids 	carry-on liquids 
bans 	bans 
to Russia 	to Russia 
Nato troops 	NATO strike 
kill 	kills 
two Afghan children 	11 Afghan children 
in east China 	into southeastern China 
landfall 	slams 
Typhoon Fitow 	Typhoon Fitow 
for James Holmes 	for James Holmes 
not guilty plea 	Not guilty plea 
Apple app 	Apple app 
directs 	sends 
drivers 	drivers 
to Alaska airport runway 	to airport 
postpones 	postpones 
family reunions 	war-torn family unions 
N Korea 	North Korea 
US Senate 	US Senate 
of fiscal impasse 	Amid Fiscal Impasse 
Iran 	Iran 
's nuclear deal 	breakthrough nuclear deal 
it 	it 
U.S. 	U.S. 
says 	says 
denies 	says 
drone 	U.S. drone 
losing 	it 
Iran 	Iran 
captures 	has seized 
escape 	escape 
's al-Kweifiya prison 	from Libyan jail 
More than 1,000 inmates 	1000 prisoners 
dies 	die 
in Cairo clash 	in Egypt clashes 
Muslim Brotherhood supporter 	Muslim Brotherhood supporters 
In Italy Tour Bus Plunge 	In Italian Bus Plunge 
Thirty-Seven Dead 	Thirty Dead 
end 	close 
lower 	lower 
China stocks 	China stocks 
Thursday 	on Thursday 
within Â ż three monthsÂ 	in months 
Iran leader Rouhani 	Iran President Hassan Rouhani 
nuclear deal 	nuclear deal 
fresh election 	fresh presidential election 
Maldives 	Maldives 
holds 	holds 
Israel 	Israel 
green-lights 	unveils 
1500 settler homes 	1,800 more settler homes 
arrested 	arrested 
five accused 	All five accused 
Mumbai photojournalist gangrape case 	Mumbai journalist gang-rape case 
from judge 	by judge 
in Spanish train crash 	in Spain crash 
questions 	questioned 
Driver 	Train driver 
airstrike 	air strikes 
in Gaza 	near Damascus 
Israel 	Israel 
launches 	launches 
Trailblazing Israeli electric car company 	Trailblazing Israeli electric car company 
to fold 	to fold 
conditional bail 	bail 
for marriage 	to get married 
granted 	granted 
Ankeet Chavan 	Ankeet Chavan 
in Spanish train crash 	in Spanish high-speed train crash 
Up to 50 dead 	Over 70 dead 
dies 	dies 
Former spokesman 	Former Reagan spokesman Larry Speakes 
drag 	drag 
lower 	lower 
US stocks 	stocks 
Weak earnings 	Weak earnings 
Three feared dead 	Three feared dead 
after helicopter 	after helicopter pub crash 
urges 	calls 
return 	for return 
to peace talks 	to peace talks 
's Peres 	's Peres 
Israel 	Israel 
against Syria 	against Syria 
US 	US 
readies 	makes 
possible solo action 	for action 
found 	found 
25 bodies 	25 more bodies 
at raided Algerian gas plant 	at Algerian gas plant 
to Cardinals 	Vatican 
Says Goodbye 	departs 
Pope Benedict XVI 	Pope Benedict XVI 
the East Coast 	East Coast 
zipping up 	to slide up 
Tropical Storm Andrea 	Tropical Storm Andrea 
Israel 	Israel 
plan 	plans 
900 settlement homes 	for new settler homes 
nasty comments 	nasty comments 
battle 	fight 
Websites 	Websites 
anonymity 	anonymity 
sets 	sets 
on fire 	on fire 
Man 	Man 
himself 	himself 
on the National Mall 	's National Mall 
fired 	fired 
after shots 	after reports 
US Capitol Hill 	US Capitol 
on lockdown 	on lockdown 
for Mekong murderers 	for Mekong murderers 
death penalties 	death sentences 
Chinese court 	Court 
upholds 	upholds 
in West Bank 	across West Bank 
detain 	Arrest 
Israeli forces 	Israeli Forces 
5 Palestinians 	Five Palestinians 
wins 	Wins 
Angela Merkel 	Merkel 
in German elections 	in Germany Election 
15 	14 
killed 	kills 
at Russian train station 	at Russian train station 
in suicide bombing 	Suicide bomber 
Cambodian opposition leader Sam Rainsy 	Cambodia opposition head 
returns 	turns 
election 	in poll bid 
calls 	calls 
Biden 	Biden 
for trust 	for trust 
call 	call 
for strike 	for strike 
in protest 	Turkey unrest 
over police violence 	over police crackdown 
2 Turkish unions 	Unions 
South African icon Nelson Mandela 	's Nelson Mandela 
hospitalized 	Hospitalized 
UBS 	UBS 
settles 	settles 
US mortgage lawsuit 	US mortgage lawsuit 
North , South Korea 	North , South Korea 
to talks 	rare talks 
gun control plans 	gun control plans 
Obama 	Obama 
to announce 	to set out 
killed 	killed 
Six Australians 	Dozens 
in Laos plane crash 	in Laos plane crash 
sarin 	sarin 
confirms 	finds 
in Syria attack 	in Syria chemical weapons attack 
UN 	U.N. 
used 	used 
$ 53m 	$ 53 million worth 
steals 	steals 
of jewels 	of jewels 
Cannes thief 	Robber 
Ex-Virginia governor Bob McDonnell 	's ex-Gov . Bob McDonnell , wife 
with corruption 	with corruption 
charged 	charged 
Pakistan 	Pakistan 
most senior Afghan Taliban prisoner 	senior Taliban commander 
to release 	to release 
bites 	bites 
costs 	costs 
Bollywood 	Bollywood 
cuts 	cuts 
as rupee collapse 	as rupee crisis 
killing 	killing 
Tornadoes 	Tornadoes 
rip 	hit 
6 	5 
through Midwest 	U.S. Midwest 
rejects 	rejects 
US hacking claims 	` groundless ' US hacking accusations 
's new PM 	China Premier Li 
New Zealand 	New Zealand 
to legalise 	to legalise 
gay marriage 	same-sex marriage 
set 	votes 
East Timor 	East Timor 
amid killings 	Amid Killings 
martial arts clubs 	Martial Arts Schools 
bans 	Bans 
at Boston Marathon 	of Boston Marathon 
loud booms 	two explosions 
election result 	election result 
Kenya Supreme Court 	Kenya SC 
upholds 	upholds 
for Wednesday 	for Today 
10 Things 	10 Things 
to Know 	to Know 
's Hugo Chavez 	Venezuelan President Hugo Chavez 
dies 	dies 
of cancer 	of cancer 
's next chair 	as New Central Bank Chief 
US Senate 	US Senate 
Yellen 	Janet Yellen 
confirms 	Confirms 
in India anti-rape protests 	in gang-rape protest 
Officer 	Indian policeman 
injured 	injured 
dies 	dies 
US 	U.S. 
in Syria 	by Syria 
Determine 	No Conclusive Evidence 
Chemical Weapons Use 	of Chemical Arms Use 
Nobel Prize winning author Doris Lessing 	Nobel laureate Doris Lessing 
dies 	dies 
Yellen 	Yellen 
as Fed head 	's next chair 
Senate 	US Senate 
confirms 	confirms 
buried 	buried 
Boston bombing suspect 	Boston bomb suspect 
in Virginia 	in Virginia cemetery 
restored 	resumes 
Internet , phone service 	Internet service 
in Syrian capital 	in Syria 
Syrian PM 	Syrian PM 
Bomb Attack 	bomb attack 
Survives 	survives 
for Nelson Mandela 	for Nelson Mandela 
prays 	in prayer and song 
South Africa 	South Africa 
At least 38 Morsi supporters 	of Morsi supporters 
die 	killed 
in clashes 	in Egypt clashes 
on iPhone disappointment 	after earnings disappointment 
Apple shares 	Apple stock 
to lure Gulf investors 	to lure investors 
set 	seeks 
Egypt 	Egypt 
Miss America 2013 	Miss America 
Miss New York 	Miss New York 
Crowned 	is crowned 
at mid-day 	at mid-day 
KLCI Futures 	KL shares 
mixed 	mixed 
Iranian exiles 	At least 47 Iranian exiles 
in Iraq camp 	's Camp Ashraf 
deaths 	killed 
in London 	in London 
Helicopter 	Helicopter 
crashes 	crashes 
China 	China 
's new defense zone 	's new defense zone 
Japanese planes 	Japan , S Korean military planes 
flew into 	defy 
Janet Yellen 	Janet Yellen 
as US Federal Reserve chief 	as next Federal Reserve Chair 
US Senate 	Senate 
confirms 	confirms 
rises 	rises 
as Storm Xaver 	as wind , rain 
Death toll 	Storm death toll 
batters 	batters 
northern Europe 	north . Europe 
in Lebanon 	in Lebanon 
kidnap 	kidnap 
airline pilots 	2 Turkish Airlines pilots 
Gunmen 	Gunmen 
U.S. drone strike 	Pakistan drone strike 
5 	up to six 
kills 	kills 
push 	pushes 
into strategic rebelheld town 	on rebel-held town 
Syrian troops 	Syrian army 
Thai opposition protesters 	Thai protesters 
Bangkok shutdown 	Bangkok ` shutdown ' 
begin 	launch 
on Syria Weapons 	on Syria 
France 	France 
after U.S.-Russia Deal 	US-Russia Deal 
Hails 	Welcomes 
About 60 	61 
Crushed 	dead 
in Ivory Coast Stampede 	in Ivory Coast stampede 
Discipline 	Discipline 
against student gunman 	against student 
thought 	thought 
on Benghazi attack 	on Benghazi attack 
to testify 	to testify 
Clinton 	Clinton 
's custom-made wheelchair 	's wheelchair 
English Channel swimmer 	Channel swimmer 
Thieves 	Thieves 
snatch 	steal 
to withdraw 	to withdraw 
Kurdish rebels 	Kurdish rebels 
from Turkey 	from Turkey 
Iranian president 	Iranian minister 
for new nuclear talks 	for failed nuke talks 
Mandela 	Mandela movie 
Queen 	US presidents 
to Nelson Mandela 	to Mandela 
pays tribute 	pay tribute 
Iraq violence 	Iraq violence 
kills 	kills 
11 	seven 
US , UK chemical arms claims 	chemical weapons 
Syria 	Syria 
Obama 	Obama 
jokes 	pokes fun at 
' dinner 	during press dinner 
21 	20 
kill 	kill 
in suicide attacks 	Car bombs 
in Niger 	near Syrian border 
's nuclear plant 	into Iran nuclear deal 
in Pakistan 	Pakistani police 
for March 11 	for January 14 
News summary 	News summary 
killed 	Six dead 
by Indonesia volcano eruption 	in Indonesian volcanic eruption 
Indonesia 	Indonesia 
gay marriage bill 	gay workers bill 
Hawaii 	US Senate 
passes 	passes 
Singapore stocks 	Indian stocks 
0.4 % higher 	higher 
close 	open 
Say 	Say 
Mar. 12 , 2013 	June 25 , 2013 
What 	What 
the Papers 	the Papers 
end up 	close 
Singapore stocks 	Singapore stocks 
0.11 pct 	0.54 pct higher 
Pakistani girls 	Pakistani girl 
of Oscar Pistorius 	Oscar Pistorius 
' girlfriend Reeva Steenkamp 	Steenkamp 
over Syria 	for Syria 
's chemical weapons 	's chemical weapons 
Egypt 	Egypt army 
Ten 	Six 
rescued 	rescued 
off Waterford , Dublin coasts 	in Dublin Bay 
Senior Pakistani Taliban commander 	Pakistan Shi'ites 
from west Chinas violence 	from NE China fire 
Death toll 	Death toll 
rises 	rises 
to 35 	to 112 
South Korean soldiers 	to South 
into North 	North Korea 
Mandela family 	Mandela family 
meets 	to meet 
Obama 	Obamas 
in hospital 	hospital 
vs 	against 
in early trade 	in early trade 
8 paise 	22 paise 
Rupee 	Rupee 
down 	up 
dollar 	dollar 
open 	close 
Indian stocks 	Indian stocks 
lower 	lower 
Four 	Owner 
arrested 	arrested 
rises 	reaches 
to 352 	372 
as Bangladesh building toll 	as Bangladesh building toll 
Indian troops 	Indian troops 
kill 	raid 
Pakistani soldier 	Pakistani military post 
Brazilian leader 	Brazil leader 
crisis talks 	reform vote 
US 	US House 
in Iraq 	across Iraq 
killed 	killed 
in attacks 	in attacks 
7 	27 
in NW Pakistan 	in NW Pakista 
killed 	killed 
injured 	injured 
12 	6 
25 	12 
in bomb blast 	in blast 
Turkish police 	British police 
Syria opposition vote 	Syrian opposition 
peace talks 	for talks 
Syria car bomb 	Sinai car bomb 
at least 12 	at least 10 Egyptian soldiers 
kills 	kills 
Bangladesh building collapse death toll 	Indian building collapse death toll 
hits 	rises 
359 	to 72 
in `` insider '' attack 	in bomb attack 
killed 	killed 
in Afghanistan 	in NW Pakistan 
Two U.S. soldiers 	8 soldiers 
kills 	kills 
10 young girls 	nine 
Blast 	Blast 
in eastern Afghanistan 	in southern Afghanistan 
at sea 	at sea 
's chemical weapons 	Syria chemical weapon stockpile 
could end up 	to destroy 
in Pakistan 	in Pakistan 
female politician 	5 female teachers 
Gunmen 	Gunmen 
kill 	kill 
Ready 	ready 
China 	China 
Dzhokhar Tsarnaev 	Dzhokhar Tsarnaev 
not guilty 	charged 
to Boston bombing charges 	in Boston Marathon bombing 
P.G. police 	Police 
seeking 	seek 
Egyptian army 	's Morsi 
Cryptic crossword 	Quiz crossword 
Saturday 27th April 	Saturday 27th April 
Angelina Jolie 	Angelina Jolie and the complex truth 
of breast cancer 	about breast cancer 
from Israeli prison 	in Israel jails 
26 Palestinian prisoners 	Palestinian prisoner 
Syria regime 	Syria army 
evacuation 	mop-up operations 
near Damascus 	near Damascus 
Twelve 	Five 
killed 	Killed 
raid 	in Blasts 
Nicaragua , Venezuela 	Bolivia 
asylum 	asylum 
to Snowden 	to Snowden 
offer 	would grant 
after Alabama school bus shooting 	in middle school shooting 
5 	3 
in Pakistan blast 	in Boston blasts 
killed 	killed 
injured 	injured 
50 	138 
to strengthen 	to strengthen 
occupied Palestinian territory 	occupied Palestinian territory 
Palestinians 	Palestinians 
coordinate 	coordinated 
on peace talks 	on peace talks 
Palestinians , Jordan 	PA 
kills 	kills 
5 	at least ten 
Suspected U.S. drone strike 	US drone strike 
in Pakistan 	in Pakistan 
to dispute 	cop on 
` Blade Runner ' Pistorius 	Pistorius 
murder charge 	seven attempted murder charges 
president 	Former New Mexico Gov. Richardson 
across Egypt 	at Cairo 
Four 	Student 
in clashes 	in clashes 
killed 	killed 
Afghan police 	5 Taliban , 5 Afghan police 
kill 	killed 
of Its Chemical Weapons Stockpile 	Chemical Weapons 
Mixed reactions 	legalizes 
to NZ same-sex marriage 	same-sex marriage 
's Shebab 	Syrian rebels 
responsibility 	responsibility 
claims 	claim 
Glasgow Helicopter Crash 	Glasgow Helicopter Crash 
India 	India 
Braces 	red alert 
for Massive Cyclone 	for cyclone Phailin 
Many 	Many 
killed 	killed 
Singapore shares 	Singapore shares 
lower 	higher 
open 	open 
on Friday 	on Thursday 
11 Dead 	kill 
Two Earthquakes 	Twin quakes 
Northwest China 	in China 
Egypt ministry 	Egypt 
to pro-Morsi protests 	after pro-Morsi protest 
